00010000000010000000
01000111010010100010
01110000011110001010
00000101110000110010
11011001010111010100
00011001010001010011
01110011010001011000
00010111011101010100
11010000010100010111
01010110010100010000
01010010010111010110
01011010000100000100
00010011110000010101
11100000010000010000